   F	37       ,100,0

NO       ./path_to_north_texture
SO ./path_to_south_texture
WE ./path_to_west_texture
EA     ./path_to_east_texture





C	37   ,     30    ,    0

111111111111111111111111111111
100000010100000100001000001001
100000000000000000000000000001
100000010100000100001000001001
111111110111111100001110111111
100000000000000100001110000001
101111111111110111111110000001
101000010000010000000000111111
101000010000011111111111100001
101000010000010000111000100001
101101111101110100111000000001
100000000000000100000000100001
111110111111110111111111101111
100010111111110100000100000001
100000000000000000000101111011
100011111111110110111101000001
111110000000000100000001000001
100000010100000100001000001001
100000010100000100001000001001
111111110111111100001110111101
100000000000000100001110000001
101101111101110100111000000001
100000000000000100000000100001
111110111111110111111111101111
100010111111110100000100000001
100000000000000000000101111011
100011111111110110111101000001
111110000000000100000001000001
100000010100000100001000001001
100000010100000100001000001001
111111110111111100001110111101
100000000000000100001110000001
101101111101110100111000000001
100000000000000100000000100001
111110111111110111111111101111
100010111111110100000100000001
100000000000000000000101111011
100011111111110110111101000001
111110000000000100000001000001
100000010100000100001000001001
100000010100000100001000001001
111111110111111100001111111101
100000000000000100001111000S01
111111111111111111111111111111


		1111111111111111111111111       111     
		1000000000110000000000001       101
		1011000001110000000000001       111
		1001000000000000000000001
111111111011000001110000000000001
100000000011000001110111111111111
1111111111111111111111



   111
11110111111111011100000010001
11110111111111011101010010001
11000000110101011100000010001
10000000000000001100000010001
10000000000000001101010010001
11000001110101011111011110N01
11110111 1110101 101111010001
11111111 1111111 111111111111
